002111010100
001220212120
021212021212
021200212122
120021202120
121021212021
212020212121
120021021021
010010121200
122102000122
010212001120
000012100000